#########
#S#   #E#
# # #   #
#   #####
#########
