#########
#S#   #E#
# # #   #
#   # # #
#########
