#############
#S###### ##E#
# ###    ## #
#   # ## #  #
# ### #### ##
#          ##
#############
