#############
#S#      #E##
# # #### # ##
# #    # #  #
# ### ## ## #
# #   #  ## #
# ## #  # # #
#    #      #
#############
