#############
#S#      ##E#
# # ## # #  #
# # #  # # ##
# ### #### ##
#           #
#############
