#############
#S##     ##E#
# # ## # #  #
# #    # # ##
# ### #### ##
#           #
#############
