#############
#S# #### ##E#
# # #    ## #
#   # ## #  #
# ### #### ##
#          ##
#############
