#############
#S# #######E#
# # #   ##  #
# # #  ### ##
# ### #### ##
#          ##
#############
