#############
#S# ####   E#
# # #    ## #
#   # ## #  #
# ### #### ##
#          ##
#############
