##################
#S####      ### E#
# #### #### ### ##
# ## # ## # ### ##
# ## #    #   # ##
#    #### ### # ##
#### #  # ### # ##
##          #    #
##################
