#############
#S# ###  ##E#
# # # #  ## #
# # # #  #  #
# ### #### ##
#          ##
#############
