#############
#S# ###  ##E#
# # # #  #  #
# # # #  # ##
# ### #### ##
#          ##
#############
